TTTTOOOOOOOIITTTT
OOTTCOOOOOOOOOTTT
TTTTOOOOOOTTTOOOT
OOOOOIIOOOOTTOOOC
OTTTOOOOOTTTTOOOT
COTTTTTOOOOOOOOTT
TTTTTTTOOOOOOOTTT
OOTTTTTOOOTTTOITT
TTTTTTTTC00ITTTTT