TTTTOOOOOOOIITTTT
OOTTCOOSOOOOOOTTT
TTTTOOOOOOTTTOOOT
OOOOOIIOXXOTTOOOC
OTTTOOOOXXTTTOOOT
COTTTTTOOXOOOOOTT
TTTTTTTOOOOOOOTTT
OOTTXTTOOOTTTOITT
TTTXXTTTCOOITTTTT
TTTTOOOTTXTTTOOTT
OOOTOOTOXXTTTTTTT
TTTTOTTTTOOOOOTXX
TTTTTTTTTTTTTXXXX